########
###    #
### ## #
##B #  #
## ## ##
#     ##
#A######
########