#######
#####B#
####  #
#### ##
#A   ##
#######
