#############
#          B#
#           #
#           #
#           #
#           #
#A          #
#############