######################
#                    #
#            #       #
#A     ###   #      B#
#                    #
#                    #
######################