##############
##          B#
## ######### #
## #       # #
## # ##### # #
##   #     # #
#### # ##### #
#A   #       #
##############